C 255,255,255
NO ./textur
SO ./textur
WE ./textur
EA ./textur
F  255,255,2


111111
1N0001
100001
100001
111111
