C 255,255,255
NO ./textures/textur
SO ./textures/textur
WE ./textures/textur
EA ./textures/textur
F  255,255,2


111111111111111111111
1S0000000000000000001
100000000000000000001
100000000000000000001
100000000000000000001
100000000000000000001
100000000000000000001
111111111111111111111
